NO ./path_to_the_north_texture
SO ./path_to_the_south_texture
WE ./path_to_the_west_texture
EA ./path_to_the_east_texture

C 255,100,0
F 255,30,0

        1111111111111111111111111    111
        1000000000110000000000001    101
        101100C00111000C000000001    111
        1001000000000000000000C01
111111111011000001110000000000001
100000000011000001110111111111111
11110111111111011100000010001
11110111111111011111010010001
1100000011010101111100000000111111
10000C00000000001111000100C0000001
10000000C0000000110101001000111111
11000001110101011111010000001
11110111 1110101 101111010N01
11111111 1111111 111111111111