NO ./textures/wood.xpm
SO ./textures/bluestone.xpm
WE ./textures/redbrick.xpm
EA ./textures/greystone.xpm

F 255,90,4
C 40,211,5

        1111111111111111111111111
        1000000000110000000000001
        101100S001110000000000001            111
        1001000000000000000000001            1001
111111111011000001110000000000001            111
100000000011000001110111111111111
11110111111111011100000010001
11110111111111011111010010001
1100000011010101111100000000111
100000000000000111100010000001
1000000000000000110101001000111
11000001110101011111010000001
11110111 1110101 101111010001
11111111 1111111 111111111111